"aa" = (/turf/simulated/floor/plating/asteroid,/area/space)
"ab" = (/turf/simulated/wall,/area/space)
"ac" = (/obj/structure/grille,/obj/structure/window/reinforced/fulltile,/turf/simulated/floor/plating,/area/space)
"ad" = (/obj/machinery/hydroponics/constructable,/turf/simulated/floor/plasteel/black,/area/space)
"ae" = (/obj/structure/grille,/obj/item/weapon/shard{icon_state = "small"},/turf/simulated/floor/plating,/area/space)
"af" = (/obj/machinery/atmospherics/pipe/simple/supply/hidden{dir = 6},/turf/simulated/floor/fancy/grass,/area/space)
"ag" = (/obj/machinery/atmospherics/pipe/manifold/supply/hidden{dir = 1},/obj/machinery/light{dir = 1},/turf/simulated/floor/fancy/grass,/area/space)
"ah" = (/obj/machinery/atmospherics/pipe/simple/supply/hidden{dir = 4},/turf/simulated/floor/fancy/grass,/area/space)
"ai" = (/obj/machinery/atmospherics/pipe/simple/supply/hidden{dir = 4},/obj/item/weapon/cultivator,/obj/item/weapon/wirecutters,/obj/item/weapon/reagent_containers/glass/bottle/mutagen,/obj/item/weapon/reagent_containers/dropper,/turf/simulated/floor/fancy/grass,/area/space)
"aj" = (/obj/machinery/atmospherics/pipe/manifold/supply/hidden{dir = 1},/turf/simulated/floor/fancy/grass,/area/space)
"ak" = (/obj/machinery/atmospherics/pipe/simple/supply/hidden{dir = 10},/obj/machinery/light{dir = 1},/turf/simulated/floor/fancy/grass,/area/space)
"al" = (/obj/item/weapon/shard,/turf/simulated/floor/plating,/area/space)
"am" = (/obj/machinery/atmospherics/pipe/simple/supply/hidden{dir = 6},/turf/simulated/floor/plating/asteroid,/area/space)
"an" = (/obj/effect/decal/cleanable/dirt,/turf/simulated/floor/plating/asteroid,/area/space)
"ao" = (/obj/machinery/atmospherics/pipe/simple/supply/hidden{dir = 4},/obj/effect/decal/cleanable/dirt,/turf/simulated/floor/plating/asteroid,/area/space)
"ap" = (/obj/machinery/atmospherics/pipe/simple/supply/hidden{dir = 4},/obj/item/weapon/cultivator,/obj/item/weapon/wirecutters,/obj/item/weapon/reagent_containers/glass/bottle/mutagen,/obj/effect/decal/cleanable/dirt,/turf/simulated/floor/plating/asteroid,/area/space)
"aq" = (/obj/machinery/atmospherics/pipe/manifold/supply/hidden{dir = 1},/obj/effect/decal/cleanable/dirt,/turf/simulated/floor/fancy/grass,/area/space)
"ar" = (/obj/item/weapon/reagent_containers/glass/bucket,/obj/item/weapon/reagent_containers/spray/plantbgone,/obj/item/weapon/reagent_containers/spray/pestspray,/turf/simulated/floor/fancy/grass,/area/space)
"as" = (/obj/machinery/atmospherics/pipe/simple/supply/hidden,/turf/simulated/floor/fancy/grass,/area/space)
"at" = (/obj/machinery/atmospherics/unary/vent_pump{dir = 1; external_pressure_bound = 0; initialize_directions = 1; internal_pressure_bound = 4000; on = 0; pressure_checks = 2; pump_direction = 0},/turf/simulated/floor/fancy/grass,/area/space)
"au" = (/turf/simulated/floor/fancy/grass,/area/space)
"av" = (/obj/structure/grille{density = 0; icon_state = "brokengrille"},/turf/simulated/floor/plating,/area/space)
"aw" = (/obj/structure/grille,/obj/item/weapon/shard,/turf/simulated/floor/plating,/area/space)
"ax" = (/obj/item/weapon/reagent_containers/glass/bucket,/obj/item/weapon/reagent_containers/spray/plantbgone,/turf/simulated/floor/plating/asteroid,/area/space)
"ay" = (/obj/machinery/atmospherics/unary/vent_pump{dir = 1; external_pressure_bound = 0; initialize_directions = 1; internal_pressure_bound = 4000; on = 0; pressure_checks = 2; pump_direction = 0},/turf/simulated/floor/plating/asteroid,/area/space)
"az" = (/obj/effect/decal/cleanable/dirt,/obj/effect/decal/cleanable/dirt,/turf/simulated/floor/fancy/grass,/area/space)
"aA" = (/obj/machinery/atmospherics/pipe/simple/supply/hidden{dir = 9},/turf/simulated/floor/fancy/grass,/area/space)
"aB" = (/obj/machinery/hydroponics/soil,/turf/simulated/floor/fancy/grass,/area/space)
"aC" = (/obj/machinery/hydroponics/soil,/obj/item/clothing/gloves/botanic_leather,/turf/simulated/floor/fancy/grass,/area/space)
"aD" = (/obj/machinery/hydroponics/soil,/obj/item/device/analyzer/plant_analyzer,/turf/simulated/floor/fancy/grass,/area/space)
"aE" = (/obj/item/weapon/screwdriver,/obj/item/weapon/reagent_containers/spray,/turf/simulated/floor/fancy/grass,/area/space)
"aF" = (/obj/machinery/atmospherics/pipe/simple/supply/hidden{dir = 4},/turf/simulated/floor/plating/asteroid,/area/space)
"aG" = (/obj/machinery/atmospherics/pipe/simple/supply/hidden{dir = 9},/turf/simulated/floor/plating/asteroid,/area/space)
"aH" = (/obj/machinery/hydroponics/soil,/obj/effect/decal/cleanable/dirt,/obj/effect/decal/cleanable/dirt,/turf/simulated/floor/fancy/grass,/area/space)
"aI" = (/obj/machinery/hydroponics/soil,/obj/effect/decal/cleanable/dirt,/turf/simulated/floor/fancy/grass,/area/space)
"aJ" = (/obj/item/device/analyzer/plant_analyzer,/turf/simulated/floor/plating/asteroid,/area/space)
"aK" = (/obj/effect/decal/cleanable/dirt,/turf/simulated/floor/fancy/grass,/area/space)
"aL" = (/obj/machinery/atmospherics/pipe/simple/supply/hidden,/obj/effect/decal/cleanable/dirt,/turf/simulated/floor/fancy/grass,/area/space)
"aM" = (/obj/item/weapon/screwdriver,/turf/simulated/floor/fancy/grass,/area/space)
"aN" = (/obj/machinery/atmospherics/pipe/manifold/supply/hidden{dir = 8},/obj/machinery/light{icon_state = "tube1"; dir = 8},/turf/simulated/floor/fancy/grass,/area/space)
"aO" = (/obj/machinery/atmospherics/unary/vent_pump{dir = 8; on = 1},/turf/simulated/floor/fancy/grass,/area/space)
"aP" = (/obj/machinery/atmospherics/unary/vent_scrubber,/turf/simulated/floor/fancy/grass,/area/space)
"aQ" = (/obj/machinery/atmospherics/pipe/manifold/supply/hidden{dir = 8},/obj/machinery/light_construct{dir = 8},/turf/simulated/floor/plating/asteroid,/area/space)
"aR" = (/obj/machinery/atmospherics/unary/vent_pump{dir = 8; on = 1},/turf/simulated/floor/plating/asteroid,/area/space)
"aS" = (/turf/simulated/floor/sepia{tag = "icon-asteroid6"; icon_state = "asteroid6"},/area/space)
"aT" = (/obj/machinery/atmospherics/unary/vent_scrubber,/obj/effect/decal/cleanable/dirt,/turf/simulated/floor/fancy/grass,/area/space)
"aU" = (/obj/machinery/atmospherics/pipe/simple/scrubbers/hidden{dir = 6},/turf/simulated/floor/fancy/grass,/area/space)
"aV" = (/obj/machinery/atmospherics/pipe/simple/scrubbers/hidden{dir = 4},/turf/simulated/floor/fancy/grass,/area/space)
"aW" = (/obj/machinery/atmospherics/pipe/manifold/scrubbers/hidden,/turf/simulated/floor/fancy/grass,/area/space)
"aX" = (/obj/machinery/atmospherics/pipe/simple/supply/hidden{req_access_txt = 1},/obj/machinery/atmospherics/pipe/simple/scrubbers/hidden{dir = 4},/turf/simulated/floor/fancy/grass,/area/space)
"aY" = (/obj/machinery/atmospherics/pipe/simple/scrubbers/hidden{dir = 10},/turf/simulated/floor/fancy/grass,/area/space)
"aZ" = (/obj/structure/grille,/obj/item/weapon/shard{icon_state = "medium"},/turf/simulated/floor/sepia{tag = "icon-asteroidplating"; icon_state = "asteroidplating"},/area/space)
"ba" = (/turf/simulated/floor/plasteel/black,/area/space)
"bb" = (/obj/machinery/atmospherics/pipe/simple/scrubbers/hidden{dir = 4},/obj/effect/decal/cleanable/dirt,/turf/simulated/floor/fancy/grass,/area/space)
"bc" = (/obj/machinery/atmospherics/pipe/manifold/scrubbers/hidden,/obj/effect/decal/cleanable/dirt,/turf/simulated/floor/fancy/grass,/area/space)
"bd" = (/obj/machinery/atmospherics/pipe/simple/supply/hidden{req_access_txt = 1},/obj/machinery/atmospherics/pipe/simple/scrubbers/hidden{dir = 4},/obj/effect/decal/cleanable/dirt,/turf/simulated/floor/fancy/grass,/area/space)
"be" = (/obj/machinery/atmospherics/pipe/simple/scrubbers/hidden,/obj/structure/reagent_dispensers/watertank,/obj/item/weapon/reagent_containers/glass/bucket,/turf/simulated/floor/fancy/grass,/area/space)
"bf" = (/obj/machinery/door/firedoor,/obj/machinery/door/airlock/glass{name = "Dome"},/turf/simulated/floor/plasteel{icon_state = "neutral"; dir = 4},/area/space)
"bg" = (/obj/machinery/atmospherics/pipe/simple/supply/hidden{req_access_txt = 1},/turf/simulated/wall,/area/space)
"bh" = (/obj/machinery/atmospherics/pipe/simple/scrubbers/visible,/turf/simulated/wall,/area/space)
"bi" = (/obj/structure/grille{density = 0; icon_state = "brokengrille"},/obj/item/weapon/shard{icon_state = "small"},/turf/simulated/floor/sepia{tag = "icon-asteroidplating"; icon_state = "asteroidplating"},/area/space)
"bj" = (/obj/effect/decal/cleanable/ash,/turf/simulated/floor/plating/asteroid,/area/space)
"bk" = (/obj/machinery/atmospherics/unary/vent_scrubber{dir = 4; on = 1; scrub_N2O = 0; scrub_Toxins = 0},/turf/simulated/floor/fancy/grass,/area/space)
"bl" = (/obj/machinery/atmospherics/pipe/manifold/scrubbers/hidden{dir = 4},/obj/structure/reagent_dispensers/watertank,/obj/item/weapon/reagent_containers/glass/bucket,/turf/simulated/floor/fancy/grass,/area/space)
"bm" = (/obj/machinery/vending/hydronutrients,/turf/simulated/floor/plasteel,/area/space)
"bn" = (/turf/simulated/floor/plasteel,/area/space)
"bo" = (/obj/machinery/atmospherics/pipe/simple/supply/visible{tag = "icon-intact (NORTHEAST)"; icon_state = "intact"; dir = 5},/turf/simulated/floor/plasteel,/area/space)
"bp" = (/obj/machinery/atmospherics/pipe/manifold/supply/hidden{dir = 1},/turf/simulated/floor/plasteel,/area/space)
"bq" = (/obj/machinery/atmospherics/pipe/simple/scrubbers/visible,/obj/machinery/atmospherics/binary/pump/on{dir = 8},/turf/simulated/floor/plasteel,/area/space)
"br" = (/obj/machinery/atmospherics/unary/tank/air{dir = 8},/turf/simulated/floor/plasteel,/area/space)
"bs" = (/obj/structure/grille{density = 0; icon_state = "brokengrille"},/turf/simulated/floor/sepia{tag = "icon-asteroidplating"; icon_state = "asteroidplating"},/area/space)
"bt" = (/obj/machinery/atmospherics/pipe/simple/supply/hidden,/turf/simulated/floor/plating/asteroid,/area/space)
"bu" = (/obj/machinery/atmospherics/unary/vent_scrubber{dir = 4; on = 1; scrub_N2O = 0; scrub_Toxins = 0},/turf/simulated/floor/plating/asteroid,/area/space)
"bv" = (/obj/effect/decal/cleanable/dirt,/turf/simulated/floor/plasteel,/area/space)
"bw" = (/obj/machinery/atmospherics/unary/tank/air{dir = 8},/obj/effect/decal/cleanable/cobweb{tag = "icon-cobweb2"; icon_state = "cobweb2"},/turf/simulated/floor/plasteel,/area/space)
"bx" = (/obj/machinery/atmospherics/pipe/manifold/supply/hidden{dir = 8},/turf/simulated/floor/fancy/grass,/area/space)
"by" = (/obj/machinery/atmospherics/pipe/simple/scrubbers/hidden,/obj/machinery/seed_extractor,/turf/simulated/floor/fancy/grass,/area/space)
"bz" = (/obj/machinery/vending/hydroseeds{slogan_delay = 700},/obj/machinery/light/small{dir = 8},/turf/simulated/floor/plasteel,/area/space)
"bA" = (/obj/machinery/atmospherics/unary/vent_pump{dir = 1; external_pressure_bound = 0; initialize_directions = 1; internal_pressure_bound = 4000; on = 0; pressure_checks = 2; pump_direction = 0},/turf/simulated/floor/plasteel,/area/space)
"bB" = (/obj/machinery/atmospherics/binary/pump/on,/turf/simulated/floor/plasteel,/area/space)
"bC" = (/obj/item/stack/rods,/turf/simulated/floor/sepia{tag = "icon-asteroidplating"; icon_state = "asteroidplating"},/area/space)
"bD" = (/obj/structure/girder,/obj/item/stack/rods,/turf/simulated/floor/sepia{tag = "icon-asteroidplating"; icon_state = "asteroidplating"},/area/space)
"bE" = (/obj/machinery/atmospherics/pipe/manifold/supply/hidden{dir = 8},/turf/simulated/floor/plating/asteroid,/area/space)
"bF" = (/obj/machinery/constructable_frame/machine_frame,/obj/item/stack/cable_coil,/turf/simulated/floor/plating/asteroid,/area/space)
"bG" = (/obj/machinery/vending/hydroseeds{slogan_delay = 700},/obj/machinery/light/small{dir = 8},/turf/simulated/floor/sepia{tag = "icon-asteroidfloor"; icon_state = "asteroidfloor"},/area/space)
"bH" = (/obj/effect/decal/cleanable/oil,/turf/simulated/floor/plasteel,/area/space)
"bI" = (/turf/simulated/floor/sepia{tag = "icon-asteroidfloor"; icon_state = "asteroidfloor"},/area/space)
"bJ" = (/obj/machinery/atmospherics/pipe/simple/supply/hidden{dir = 5},/obj/machinery/light{icon_state = "tube1"; dir = 8},/turf/simulated/floor/fancy/grass,/area/space)
"bK" = (/obj/machinery/atmospherics/pipe/simple/supply/hidden{dir = 10},/turf/simulated/floor/fancy/grass,/area/space)
"bL" = (/obj/machinery/atmospherics/pipe/simple/scrubbers/hidden,/turf/simulated/floor/fancy/grass,/area/space)
"bM" = (/obj/structure/cable/yellow{d1 = 2; d2 = 4; icon_state = "2-4"; tag = ""},/turf/simulated/floor/plasteel,/area/space)
"bN" = (/obj/machinery/power/apc{cell_type = 25000; dir = 2; name = "Biodome APC"; pixel_y = -25},/obj/structure/cable/yellow{d2 = 8; icon_state = "0-8"},/turf/simulated/floor/plasteel,/area/space)
"bO" = (/obj/machinery/biogenerator,/turf/simulated/floor/plasteel{icon_state = "bot"},/area/space)
"bP" = (/obj/machinery/pipedispenser,/turf/simulated/floor/plasteel,/area/space)
"bQ" = (/obj/machinery/atmospherics/unary/tank{name = "Waste tank"},/turf/simulated/floor/plasteel,/area/space)
"bR" = (/turf/simulated/floor/sepia{tag = "icon-asteroidplating"; icon_state = "asteroidplating"},/area/space)
"bS" = (/turf/simulated/floor/sepia{tag = "icon-asteroid7"; icon_state = "asteroid7"},/area/space)
"bT" = (/obj/machinery/atmospherics/pipe/simple/supply/hidden{dir = 10},/turf/simulated/floor/plating/asteroid,/area/space)
"bU" = (/obj/structure/girder,/obj/item/stack/sheet/metal,/turf/simulated/floor/plating,/area/space)
"bV" = (/obj/structure/cable/yellow{d1 = 2; d2 = 4; icon_state = "2-4"; tag = ""},/turf/simulated/floor/sepia{tag = "icon-asteroidfloor"; icon_state = "asteroidfloor"},/area/space)
"bW" = (/obj/machinery/power/apc{cell_type = 25000; dir = 2; name = "Biodome APC"; pixel_y = -25},/obj/structure/cable/yellow{d2 = 8; icon_state = "0-8"},/turf/simulated/floor/sepia{tag = "icon-asteroidfloor"; icon_state = "asteroidfloor"},/area/space)
"bX" = (/obj/machinery/atmospherics/pipe/simple/supply/hidden{req_access_txt = 1},/turf/simulated/floor/fancy/grass,/area/space)
"bY" = (/obj/machinery/atmospherics/pipe/simple/scrubbers/hidden{dir = 9},/turf/simulated/floor/fancy/grass,/area/space)
"bZ" = (/obj/machinery/door/airlock/external{req_access_txt = "0"; req_one_access_txt = "13,8"},/obj/structure/cable/yellow{d1 = 1; d2 = 2; icon_state = "1-2"; pixel_y = 0},/turf/simulated/floor/plating,/area/space)
"ca" = (/obj/machinery/atmospherics/unary/vent_scrubber{dir = 4; on = 1; scrub_N2O = 0; scrub_Toxins = 0},/obj/item/stack/sheet/metal,/turf/simulated/floor/plating/asteroid,/area/space)
"cb" = (/obj/machinery/atmospherics/pipe/simple/scrubbers/hidden{dir = 9},/turf/simulated/floor/plating/asteroid,/area/space)
"cc" = (/obj/machinery/atmospherics/pipe/simple/supply/hidden{dir = 5},/turf/simulated/floor/fancy/grass,/area/space)
"cd" = (/obj/machinery/atmospherics/pipe/simple/supply/hidden{dir = 4},/turf/simulated/wall,/area/space)
"ce" = (/obj/machinery/atmospherics/unary/vent_pump{dir = 8; external_pressure_bound = 0; frequency = 1441; id_tag = "co2_out"; initialize_directions = 1; internal_pressure_bound = 4000; on = 1; pressure_checks = 2; pump_direction = 0},/obj/structure/cable/yellow{d1 = 1; d2 = 4; icon_state = "1-4"; tag = "90Curve"},/obj/structure/cable/yellow{d1 = 1; d2 = 2; icon_state = "1-2"; pixel_y = 0},/turf/simulated/floor/plasteel,/area/space)
"cf" = (/obj/structure/cable/yellow{d1 = 4; d2 = 8; icon_state = "4-8"},/turf/simulated/floor/plasteel,/area/space)
"cg" = (/obj/structure/cable/yellow{d1 = 2; d2 = 8; icon_state = "2-8"},/obj/machinery/light/small{dir = 4},/turf/simulated/floor/plasteel,/area/space)
"ch" = (/obj/structure/cable/yellow{icon_state = "0-2"; d2 = 2},/obj/machinery/power/solar{id = "forestarboard"; name = "Fore-Starboard Solar Array"},/turf/simulated/floor/plasteel/airless{icon_state = "solarpanel"},/area/space)
"ci" = (/obj/machinery/atmospherics/pipe/simple/supply/hidden{dir = 5},/turf/simulated/floor/plating/asteroid,/area/space)
"cj" = (/obj/machinery/atmospherics/unary/vent_pump{dir = 8; external_pressure_bound = 0; frequency = 1441; id_tag = "co2_out"; initialize_directions = 1; internal_pressure_bound = 4000; on = 1; pressure_checks = 2; pump_direction = 0},/obj/structure/cable/yellow{d1 = 1; d2 = 4; icon_state = "1-4"; tag = "90Curve"},/obj/structure/cable/yellow{d1 = 1; d2 = 2; icon_state = "1-2"; pixel_y = 0},/turf/simulated/floor/sepia{tag = "icon-asteroidfloor"; icon_state = "asteroidfloor"},/area/space)
"ck" = (/obj/structure/cable/yellow{d1 = 4; d2 = 8; icon_state = "4-8"},/turf/simulated/floor/sepia{tag = "icon-asteroidfloor"; icon_state = "asteroidfloor"},/area/space)
"cl" = (/obj/structure/cable/yellow{d1 = 2; d2 = 8; icon_state = "2-8"},/obj/machinery/light_construct/small{tag = "icon-bulb-construct-stage1 (EAST)"; icon_state = "bulb-construct-stage1"; dir = 4},/turf/simulated/floor/sepia{tag = "icon-asteroidfloor"; icon_state = "asteroidfloor"},/area/space)
"cm" = (/obj/structure/cable/yellow{icon_state = "0-2"; d2 = 2},/turf/simulated/floor/sepia{tag = "icon-asteroidplating"; icon_state = "asteroidplating"},/area/space)
"cn" = (/obj/machinery/power/solar_control{id = "biodome"; name = "Biodome Solar Control"; track = 0},/obj/structure/cable/yellow,/turf/simulated/floor/plating,/area/space)
"co" = (/obj/structure/cable/yellow{d1 = 2; d2 = 4; icon_state = "2-4"; tag = ""},/turf/simulated/floor/plating,/area/space)
"cp" = (/obj/structure/cable/yellow{d1 = 4; d2 = 8; icon_state = "4-8"},/turf/simulated/floor/plating,/area/space)
"cq" = (/obj/structure/cable/yellow{d1 = 4; d2 = 8; icon_state = "4-8"; pixel_x = 0; tag = ""},/obj/structure/cable/yellow{d1 = 1; d2 = 8; icon_state = "1-8"; tag = ""},/obj/structure/cable/yellow{d1 = 2; d2 = 8; icon_state = "2-8"; tag = ""},/turf/simulated/floor/plating,/area/space)
"cr" = (/obj/machinery/power/tracker{id = "biodome"},/obj/structure/cable/yellow{d2 = 8; icon_state = "0-8"},/turf/simulated/floor/plating,/area/space)
"cs" = (/obj/structure/girder,/obj/item/stack/sheet/metal,/turf/simulated/floor/sepia{tag = "icon-asteroidplating"; icon_state = "asteroidplating"},/area/space)
"ct" = (/obj/structure/cable/yellow{d1 = 4; d2 = 8; icon_state = "4-8"},/turf/simulated/floor/sepia{tag = "icon-asteroidplating"; icon_state = "asteroidplating"},/area/space)
"cu" = (/obj/structure/cable/yellow{d1 = 4; d2 = 8; icon_state = "4-8"; pixel_x = 0; tag = ""},/obj/structure/cable/yellow{d1 = 1; d2 = 8; icon_state = "1-8"; tag = ""},/obj/structure/cable/yellow{d1 = 2; d2 = 8; icon_state = "2-8"; tag = ""},/turf/simulated/floor/sepia{tag = "icon-asteroidplating"; icon_state = "asteroidplating"},/area/space)
"cv" = (/obj/machinery/power/tracker{id = "biodome"},/obj/structure/cable/yellow{d2 = 8; icon_state = "0-8"},/turf/simulated/floor/sepia{tag = "icon-asteroidplating"; icon_state = "asteroidplating"},/area/space)
"cw" = (/obj/structure/cable/yellow{d1 = 1; d2 = 2; icon_state = "1-2"; pixel_y = 0},/turf/simulated/floor/plating,/area/space)
"cx" = (/obj/structure/cable,/obj/machinery/power/solar{id = "forestarboard"; name = "Fore-Starboard Solar Array"},/turf/simulated/floor/plasteel/airless{icon_state = "solarpanel"},/area/space)
"cy" = (/obj/structure/girder,/turf/simulated/floor/sepia{tag = "icon-asteroidplating"; icon_state = "asteroidplating"},/area/space)
"cz" = (/obj/structure/cable/yellow{d1 = 1; d2 = 2; icon_state = "1-2"; pixel_y = 0},/turf/simulated/floor/sepia{tag = "icon-asteroidplating"; icon_state = "asteroidplating"},/area/space)
"cA" = (/obj/structure/cable/yellow,/turf/simulated/floor/sepia{tag = "icon-asteroidplating"; icon_state = "asteroidplating"},/area/space)
"cB" = (/obj/structure/cable/yellow{d1 = 1; d2 = 4; icon_state = "1-4"; tag = "90Curve"},/turf/simulated/floor/plating,/area/space)
"cC" = (/obj/structure/cable/yellow{d1 = 1; d2 = 8; icon_state = "1-8"; tag = ""},/turf/simulated/floor/plating,/area/space)
"cD" = (/obj/structure/cable/yellow{d1 = 1; d2 = 4; icon_state = "1-4"; tag = "90Curve"},/turf/simulated/floor/sepia{tag = "icon-asteroidplating"; icon_state = "asteroidplating"},/area/space)
"cE" = (/obj/structure/cable/yellow{d1 = 1; d2 = 8; icon_state = "1-8"; tag = ""},/turf/simulated/floor/sepia{tag = "icon-asteroidplating"; icon_state = "asteroidplating"},/area/space)

(1,1,1) = {"
aaaaaaaaaaaaaaaaaaaaaaaaaaaaaaaaaaaaaaaaaaaaaaaaaaaaaaaaaaaaaaaaaaaaaaaaaaaaaaaaaaaaaaaa
aaaaaaaaaaaaaaaaaaaaaaaaaaaaaaaaaaaaaaaaaaaaaaaaaaaaaaaaaaaaaaaaaaaaaaaaaaaaaaaaaaaaaaaa
aaaaaaaaaaaaaaaaaaaaaaaaaaaaaaaaaaaaaaaaaaaaaaaaaaaaaaaaaaaaaaaaaaaaaaaaaaaaaaaaaaaaaaaa
aaaaaaaaaaabacacacabaaaaaaaaaaaaaaaaaaaaaaaaaaaaaaaaaaabacacacabaaaaaaaaaaaaaaaaaaaaaaaa
aaaaaaacababadadadababacaaaaaaaaaaaaaaaaaaaaaaaaaaaeababadadadababacaaaaaaaaaaaaaaaaaaaa
aaaaacacafagahaiahajakacacaaaaaaaaaaaaaaaaaaaaaaalaeamanaoapaoaqakacacaaaaaaaaaaaaaaaaaa
aaacacarasatauauauatasauacacaaaaaaaaaaaaaaaaaaavawaxaaayazanazayasauacacaaaaaaaaaaaaaaaa
aaabafahaAauaBaCaDauasauaEabaaaaaaaaaaaaaaaaaaabamaFaGaaaHaIaJaKaLauaMabaaaaaaaaaaaaaaaa
ababaNaOauauauauaPauasaPauababaaaaaaaaaaaaaaababaQaRaaaSaaanaTazasaPauababaaaaaaaaaaaaaa
acadasauaBauaUaVaWaVaXaWaYauacaaaaaaaaaaaaaaaZbaaaaaaaaaaabbbcbbbdaWaYauacaaaaaaaaaaaaaa
acadasauaBaubeababbfbgabbhababaaaaaaaaaaaaaabibaaaaSaSbjbeababbfbgabbhababaaaaaaaaaaaaaa
acadasauaBbkblabbmbnbobpbqbrabaaaaaaaaaaaaaabsbabtaaaabuaaabbmbvbobpbqbwabaaaaaaaaaaaaaa
ababbxaOauaubyabbzbnbnbAbBababaaaaaaaaaaaaaabCbDbEaRbjaabFabbGbHbIbAbBababaaaaaaaaaaaaaa
aaabbJahbKaubLabbMbNbObPbQabaaaaaaaaaaaaaaaaaabRaabSbTaaaabUbVbWbObPbQabaaaaaaaaaaaaaaaa
aaacacaubXbkbYabbZabababababaaaaaaaaaaaaaaaaaabRbRaaaacacbabbZabababababaaaaaaaaaaaaaaaa
aaaaacacccahahcdcecfcgababaaaaaachchchchchaaaaaabRbRciaSaFcdcjckclababaaaaaabRchbRchcmaa
aaaaaaacababauabcnabbZabaaaacocpcqcqcqcqcqcraaaaaabRbRcsaaabcnabbZabaaaabRctbRcucubRcucv
aaaaaaaaaaabacabababcwaaaaaacwaacxcxcxcxcxaaaaaaaaaaaacybsabababczaaaaaabRaacxcxcAcxcxaa
aaaaaaaaaaaaaaaaaaaacBcpcpcpcCaaaaaaaaaaaaaaaaaaaaaaaaaaaaaaaaaacDctbRctcEaaaaaaaaaaaaaa
aaaaaaaaaaaaaaaaaaaaaaaaaaaaaaaaaaaaaaaaaaaaaaaaaaaaaaaaaaaaaaaaaaaaaaaaaaaaaaaaaaaaaaaa
"}
